NO ./textures/brick.png
SO ./textures/metal.png
WE ./textures/stone.png
EA ./textures/wood.png

F 220,220,220
C 0,0,0

1111111111
1000000001
100E010001
1000110001
1110000001
1111111111
