NO ./textures/brick.png
SO ./textures/metal.png
WE ./textures/stone.png
EA ./textures/wood.png
F	 5 , 2, 5

C	20,20,20
        1111111111111111111111111
        1000000000110000000000001
        1011000001110000000000001
        1001000000000000000000011
111111111011000001110000000000001
100000000011000001110111111111111
111101111111110111000000100011
111101111111110111010100100011
110000001101010111000000100011
10000000000000001100000010011111111
10000000000000001101010010011000001
11000001110101011111011110W01
11110111 1110101 101111010001
11111111 1111111 111111111111
