NO       ./textures/north.png
SO textures/south.png
WE                      textures/west.png
F	180, 120,0
EA ./textures/east.png




C			 			,		,




111111111111111111111111111111111
        1111111111111111111111111
        1000000000110000000000001
        1011000001110000000000001
        1001000000000000000000001
111111111011000001110000000000001
100000000011000000110110011111111
11110111111111011000000000001
11110111111111011101010010001
11000000110101011100000010001
10000000000000001100000010001
10000000000000001101010010001
11000001110101011111011110N0111
11110111 1110101 101111010001
11111111 1111111 111111111111




